"aa" = (/turf/template_noop,/area/template_noop)
"ab" = (/turf/open/floor/plating/asteroid/snow,/area/awaymission/snowdin)
"ac" = (/obj/structure/flora/grass/brown,/turf/open/floor/plating/asteroid/snow,/area/awaymission/snowdin)
"ad" = (/obj/structure/flora/tree/pine,/turf/open/floor/plating/asteroid/snow,/area/awaymission/snowdin)
"ae" = (/obj/structure/statue/snow/snowman,/turf/open/floor/plating/asteroid/snow,/area/awaymission/snowdin)
"af" = (/turf/closed/wall/ice{baseturf = /turf/open/floor/plating/asteroid/snow},/area/awaymission/snowdin)
"ag" = (/obj/machinery/door/airlock/external,/turf/open/floor/plating{baseturf = /turf/open/floor/plating/asteroid/snow},/area/awaymission/snowdin)
"ah" = (/obj/structure/flora/bush,/turf/open/floor/plating/asteroid/snow,/area/awaymission/snowdin)
"ai" = (/obj/structure/grille,/obj/structure/window/reinforced/fulltile/ice,/turf/open/floor/plating{baseturf = /turf/open/floor/plating/asteroid/snow; icon = 'icons/turf/snow.dmi'; temperature = 140},/area/awaymission/snowdin)
"aj" = (/turf/open/floor/plating{baseturf = /turf/open/floor/plating/asteroid/snow},/area/awaymission/snowdin)
"ak" = (/obj/structure/girder,/turf/open/floor/plating{baseturf = /turf/open/floor/plating/asteroid/snow; icon = 'icons/turf/snow.dmi'; temperature = 140},/area/awaymission/snowdin)
"al" = (/turf/open/floor/plating{baseturf = /turf/open/floor/plating/asteroid/snow; icon = 'icons/turf/snow.dmi'; temperature = 140},/area/awaymission/snowdin)
"am" = (/turf/open/floor/plasteel{baseturf = /turf/open/floor/plating/asteroid/snow; wet = 0},/area/awaymission/snowdin)
"an" = (/obj/structure/grille{color = "#FFFF00"},/obj/structure/window/reinforced/fulltile/ice,/turf/open/floor/plating{baseturf = /turf/open/floor/plating/asteroid/snow; icon = 'icons/turf/snow.dmi'; temperature = 140},/area/awaymission/snowdin)
"ao" = (/obj/item/weapon/shard,/turf/open/floor/plating/asteroid/snow,/area/awaymission/snowdin)
"ap" = (/obj/item/weapon/shard,/turf/open/floor/plasteel{baseturf = /turf/open/floor/plating/asteroid/snow; wet = 0},/area/awaymission/snowdin)
"aq" = (/obj/structure/grille{density = 0; icon_state = "brokengrille"},/turf/open/floor/plating{baseturf = /turf/open/floor/plating/asteroid/snow; icon = 'icons/turf/snow.dmi'; temperature = 140},/area/awaymission/snowdin)
"ar" = (/obj/machinery/light/built,/turf/open/floor/plasteel{baseturf = /turf/open/floor/plating/asteroid/snow; wet = 0},/area/awaymission/snowdin)
"as" = (/obj/structure/girder,/turf/open/floor/plating/asteroid/snow,/area/awaymission/snowdin)
"at" = (/obj/item/stack/sheet/metal,/turf/open/floor/plating/asteroid/snow,/area/awaymission/snowdin)
"au" = (/obj/structure/bed,/obj/item/weapon/bedsheet,/obj/effect/landmark/awaystart,/turf/open/floor/carpet{baseturf = /turf/open/floor/plating/asteroid/snow},/area/awaymission/snowdin)
"av" = (/obj/structure/table/wood,/turf/open/floor/carpet{baseturf = /turf/open/floor/plating/asteroid/snow},/area/awaymission/snowdin)
"aw" = (/obj/structure/closet/cabinet,/obj/item/clothing/shoes/winterboots,/obj/item/clothing/suit/hooded/wintercoat,/obj/item/clothing/gloves/color/black,/turf/open/floor/carpet{baseturf = /turf/open/floor/plating/asteroid/snow},/area/awaymission/snowdin)
"ax" = (/turf/open/floor/carpet{baseturf = /turf/open/floor/plating/asteroid/snow},/area/awaymission/snowdin)
"ay" = (/obj/structure/bed,/obj/item/weapon/bedsheet,/turf/open/floor/carpet{baseturf = /turf/open/floor/plating/asteroid/snow},/area/awaymission/snowdin)
"az" = (/turf/open/floor/plasteel/cafeteria{baseturf = /turf/open/floor/plating/asteroid/snow},/area/awaymission/snowdin)
"aA" = (/obj/machinery/door/airlock/glass,/turf/open/floor/plasteel/cafeteria{baseturf = /turf/open/floor/plating/asteroid/snow},/area/awaymission/snowdin)
"aB" = (/obj/machinery/door/airlock{name = "Dorm Room"},/turf/open/floor/carpet{baseturf = /turf/open/floor/plating/asteroid/snow},/area/awaymission/snowdin)
"aC" = (/obj/structure/bed,/obj/item/weapon/bedsheet,/obj/machinery/light/built{tag = "icon-tube1 (EAST)"; icon_state = "tube1"; dir = 4},/obj/effect/landmark/awaystart,/turf/open/floor/carpet{baseturf = /turf/open/floor/plating/asteroid/snow},/area/awaymission/snowdin)
"aD" = (/obj/machinery/light{dir = 8},/turf/open/floor/plating{baseturf = /turf/open/floor/plating/asteroid/snow; icon = 'icons/turf/snow.dmi'; temperature = 140},/area/awaymission/snowdin)
"aE" = (/obj/item/stack/sheet/metal,/turf/open/floor/plating{baseturf = /turf/open/floor/plating/asteroid/snow; icon = 'icons/turf/snow.dmi'; temperature = 140},/area/awaymission/snowdin)
"aF" = (/obj/machinery/light/small{dir = 4},/turf/open/floor/plating/asteroid/snow,/area/awaymission/snowdin)
"aG" = (/obj/machinery/light{dir = 1},/turf/open/floor/plating{baseturf = /turf/open/floor/plating/asteroid/snow; icon = 'icons/turf/snow.dmi'; temperature = 140},/area/awaymission/snowdin)
"aH" = (/obj/machinery/light/built{tag = "icon-tube1 (NORTH)"; icon_state = "tube1"; dir = 1},/turf/open/floor/plating{baseturf = /turf/open/floor/plating/asteroid/snow; icon = 'icons/turf/snow.dmi'; temperature = 140},/area/awaymission/snowdin)
"aI" = (/mob/living/simple_animal/hostile/bear/snow,/turf/open/floor/plating/asteroid/snow,/area/awaymission/snowdin)
"aJ" = (/obj/machinery/light/built,/turf/open/floor/plating{baseturf = /turf/open/floor/plating/asteroid/snow; icon = 'icons/turf/snow.dmi'; temperature = 140},/area/awaymission/snowdin)
"aK" = (/obj/effect/decal/cleanable/blood/drip,/turf/open/floor/plasteel{baseturf = /turf/open/floor/plating/asteroid/snow; wet = 0},/area/awaymission/snowdin)
"aL" = (/obj/effect/decal/cleanable/blood/drip,/turf/open/floor/plating/asteroid/snow,/area/awaymission/snowdin)
"aM" = (/mob/living/simple_animal/bot/cleanbot{name = "\improper Cleanksy"},/turf/open/floor/plasteel/darkbrown{baseturf = /turf/open/floor/plating/asteroid/snow},/area/awaymission/snowdin)
"aN" = (/turf/open/floor/plasteel/darkbrown{baseturf = /turf/open/floor/plating/asteroid/snow},/area/awaymission/snowdin)
"aO" = (/obj/structure/table,/obj/item/weapon/paper_bin,/obj/item/weapon/pen,/turf/open/floor/plasteel/darkbrown{baseturf = /turf/open/floor/plating/asteroid/snow},/area/awaymission/snowdin)
"aP" = (/obj/structure/table,/obj/item/weapon/paper/crumpled/snowdin/shovel,/turf/open/floor/plasteel/darkbrown{baseturf = /turf/open/floor/plating/asteroid/snow},/area/awaymission/snowdin)
"aQ" = (/obj/structure/table,/obj/item/device/flashlight/lamp,/turf/open/floor/plasteel/darkbrown{baseturf = /turf/open/floor/plating/asteroid/snow},/area/awaymission/snowdin)
"aR" = (/obj/machinery/space_heater,/turf/open/floor/plating{baseturf = /turf/open/floor/plating/asteroid/snow; icon = 'icons/turf/snow.dmi'; temperature = 140},/area/awaymission/snowdin)
"aS" = (/obj/structure/table,/obj/item/weapon/storage/toolbox/electrical,/obj/item/weapon/storage/toolbox/electrical,/turf/open/floor/plating{baseturf = /turf/open/floor/plating/asteroid/snow; icon = 'icons/turf/snow.dmi'; temperature = 140},/area/awaymission/snowdin)
"aT" = (/obj/structure/filingcabinet,/turf/open/floor/plasteel/darkbrown{baseturf = /turf/open/floor/plating/asteroid/snow},/area/awaymission/snowdin)
"aU" = (/mob/living/simple_animal/hostile/syndicate{health = 50; maxHealth = 50; name = "Weakened Syndicate Operative"; speed = 2},/turf/open/floor/plasteel/darkbrown{baseturf = /turf/open/floor/plating/asteroid/snow},/area/awaymission/snowdin)
"aV" = (/obj/structure/chair{dir = 1},/turf/open/floor/plasteel/darkbrown{baseturf = /turf/open/floor/plating/asteroid/snow},/area/awaymission/snowdin)
"aW" = (/obj/effect/decal/cleanable/blood/drip,/turf/open/floor/plating{baseturf = /turf/open/floor/plating/asteroid/snow; icon = 'icons/turf/snow.dmi'; temperature = 140},/area/awaymission/snowdin)
"aX" = (/obj/item/weapon/shovel,/turf/open/floor/plating{baseturf = /turf/open/floor/plating/asteroid/snow; icon = 'icons/turf/snow.dmi'; temperature = 140},/area/awaymission/snowdin)
"aY" = (/obj/structure/table,/obj/item/weapon/storage/toolbox/mechanical,/obj/item/weapon/storage/toolbox/mechanical,/turf/open/floor/plating{baseturf = /turf/open/floor/plating/asteroid/snow; icon = 'icons/turf/snow.dmi'; temperature = 140},/area/awaymission/snowdin)
"aZ" = (/obj/item/weapon/shard,/turf/open/floor/plating{baseturf = /turf/open/floor/plating/asteroid/snow; icon = 'icons/turf/snow.dmi'; temperature = 140},/area/awaymission/snowdin)
"ba" = (/obj/machinery/light{dir = 4; icon_state = "tube1"},/turf/open/floor/plating/asteroid/snow,/area/awaymission/snowdin)
"bb" = (/obj/machinery/light{dir = 8},/obj/structure/filingcabinet,/obj/item/weapon/paper/snowdin/snowdinlog2,/turf/open/floor/plasteel/darkbrown{baseturf = /turf/open/floor/plating/asteroid/snow},/area/awaymission/snowdin)
"bc" = (/obj/effect/decal/cleanable/blood/drip,/turf/open/floor/plasteel/darkbrown{baseturf = /turf/open/floor/plating/asteroid/snow},/area/awaymission/snowdin)
"bd" = (/obj/machinery/door/airlock/hatch,/turf/open/floor/plasteel/darkbrown{baseturf = /turf/open/floor/plating/asteroid/snow},/area/awaymission/snowdin)
"be" = (/obj/machinery/door/airlock/maintenance_hatch,/turf/open/floor/plating{baseturf = /turf/open/floor/plating/asteroid/snow},/area/awaymission/snowdin)
"bf" = (/obj/machinery/power/terminal{dir = 4},/turf/open/floor/plating{baseturf = /turf/open/floor/plating/asteroid/snow; icon = 'icons/turf/snow.dmi'; temperature = 140},/area/awaymission/snowdin)
"bg" = (/obj/machinery/power/smes/magical{desc = "A high-capacity superconducting magnetic energy storage (SMES) unit."; name = "power storage unit"},/turf/open/floor/plating{baseturf = /turf/open/floor/plating/asteroid/snow; icon = 'icons/turf/snow.dmi'; temperature = 140},/area/awaymission/snowdin)
"bh" = (/obj/effect/decal/cleanable/vomit,/turf/open/floor/plasteel/darkbrown{baseturf = /turf/open/floor/plating/asteroid/snow},/area/awaymission/snowdin)
"bi" = (/obj/structure/chair,/turf/open/floor/plasteel/darkbrown{baseturf = /turf/open/floor/plating/asteroid/snow},/area/awaymission/snowdin)
"bj" = (/obj/machinery/power/port_gen/pacman,/turf/open/floor/plating{baseturf = /turf/open/floor/plating/asteroid/snow; icon = 'icons/turf/snow.dmi'; temperature = 140},/area/awaymission/snowdin)
"bk" = (/obj/effect/spawner/lootdrop/snowdin/dungeonlite,/turf/open/floor/plasteel/darkbrown{baseturf = /turf/open/floor/plating/asteroid/snow},/area/awaymission/snowdin)
"bl" = (/obj/structure/table,/turf/open/floor/plasteel/darkbrown{baseturf = /turf/open/floor/plating/asteroid/snow},/area/awaymission/snowdin)
"bm" = (/obj/structure/reagent_dispensers/fueltank,/turf/open/floor/plating{baseturf = /turf/open/floor/plating/asteroid/snow; icon = 'icons/turf/snow.dmi'; temperature = 140},/area/awaymission/snowdin)
"bn" = (/obj/structure/reagent_dispensers/watertank,/turf/open/floor/plating{baseturf = /turf/open/floor/plating/asteroid/snow; icon = 'icons/turf/snow.dmi'; temperature = 140},/area/awaymission/snowdin)
"bo" = (/obj/structure/closet/crate,/obj/item/weapon/survivalcapsule,/turf/open/floor/plating{baseturf = /turf/open/floor/plating/asteroid/snow; icon = 'icons/turf/snow.dmi'; temperature = 140},/area/awaymission/snowdin)
"bp" = (/obj/machinery/light/small{dir = 1},/turf/open/floor/plating/asteroid/snow,/area/awaymission/snowdin)

(1,1,1) = {"
aaaaaaaaaaaaaaaaaaaaaaaaaaaaaaaaaaaaababababababababababababacababababababababad
aaaaaaaaaaaaaaaaaaaaaaaaaaaaaaaaababababababababababababababacababacabababaaaaab
aaabababababababababababababababaeababababababafagagafabababacabababababaaaaaaaa
acabababacababababababababaaaaababaaahababababaiajajaiababababababababaaaaaaaaaa
acabadabacabadabababababaaaaababaaaaabababababaiajajaiababababababababaaaaaaaaaa
acabababacabababadababaaaaaaaaaaaaababababababafagagafafafakakafafabababaaaaaaaa
acabababacabababababaaaaaaaaaaaaabababababababalalalalamamamamamamanababababaaaa
abababababababababaaaaaaaaaaaaaaabababababaoabababalalalalamapamamamaqababababab
ababababababababaaaaaaaaaaaaaaababababababababalalalalalamaramamamamamalabababab
abababababababaaaaaaaaaaaaaaabababaoabasabasafafamamafafafafafafafamapamafabadab
ababababababaaaaaaaaaaaaaaabaoabababatababalalafamamafauavawawavafamamalafababab
ababababaaaaaaaaaaaaaaababafalababababababalalafamamafaxaxaxaxayafamalabafababab
ababaaaaaaaaaaaaaaaaabababafalababasabababalazaAamamaBaxaxaxaxaCafaDalabafababab
abaaaaaaaaaaaaaaabababababafalababafalaEalalazafamamafaxaxaxaxayafalababafababab
abaaaaaaaaaaabababababababafabababafazalalazazafamamafayavawawavafalabababababab
abaaaaaaabababababaFafaiaiafababalafafafafafafafamamafafafafafafafalabababababab
ababababababababababagajajagababalalalalaGalamamamamamalalaHalababababababababab
abaIabababaIababababagajajagabababababalaJalalalamamaKamalalalabaLabababagababab
abababababababababaFafaiaiafalababafafafafafafafamalafafakafafafafabababafababab
abababababababababababababafalababafaMaNaOaPaQafalalafaRaRaEalaSafabababafababab
abababababababababababababafalababafaTaUaNaVaNafaWalafaXalalalaYafabaLabafababab
abababababababababababababafalaZbaafbbaNaNbcaNbdalalbealbfbgalalasabababafababab
abababababababababababababafamalalafaTbhaNbiaNafalabafalalalalbjatabababababaLab
abababaIabababaIabababababafamamabafbkaNaQblaOafababafbmbnboabababaoabababababab
abababababababababababababafamabamafafafafafafafababafafafafabababababababababab
ababababababababababababababaiamamabalalalalalalabababababababababababababababab
abababababababababababababababaqaZalalabababababababababababababababababababacac
ababababababababababababababababaqalalalababababababababababababababababababacac
abababababababababababababababababafafafafafafafagabababababacacabababababababab
ababababababababadababababababababababababababaqababababababacacabababababababab
abababababababababababababababababababababababalabababababababababababababahabab
abababababababababababababababababababababababafagababababababababababababababab
aaababababababababababababababababababababababbpabababababababababababababababab
aaaaabababababababababababababababababababababababababababababababababababababab
aaaaababadababababababababababababababababababababababababadabababababababababab
aaaaaaababababababababadabababababababababababababababababababababahabababahabaa
aaaaaaaaabababababababababababababababababababababababababababababababababababaa
aaaaaaaaababababababababababababababababababababababababababababababababaaaaaaaa
aaaaaaaaaaababababababababababababababababababababababababababababaaaaaaaaaaaaaa
aaaaaaaaaaaaabababababababababababababababababababadabababababaaaaaaaaaaaaaaaaaa
"}
