"aa" = (/turf/template_noop,/area/template_noop)
"ab" = (/turf/open/floor/plating/asteroid/snow,/area/awaymission/snowdin)
"ac" = (/turf/closed/wall/ice{baseturf = /turf/open/floor/plating/asteroid/snow},/area/awaymission/snowdin/base)
"ad" = (/obj/structure/filingcabinet,/obj/item/weapon/paper/snowdin/secnotice,/turf/open/floor/plasteel/darkred{baseturf = /turf/open/floor/plating/asteroid/snow},/area/awaymission/snowdin/base)
"ae" = (/obj/machinery/light/small{dir = 1},/turf/open/floor/plasteel/darkred{baseturf = /turf/open/floor/plating/asteroid/snow},/area/awaymission/snowdin/base)
"af" = (/obj/item/weapon/gun/ballistic/shotgun/boltaction,/obj/item/ammo_box/a762,/obj/item/ammo_box/a762,/obj/structure/closet/secure_closet{icon_state = "sec"; locked = 1; name = "security officer's locker"; req_access_txt = "201"},/obj/item/weapon/restraints/handcuffs,/obj/item/device/assembly/flash,/obj/item/weapon/storage/box/lethalshot,/turf/open/floor/plasteel/darkred{baseturf = /turf/open/floor/plating/asteroid/snow},/area/awaymission/snowdin/base)
"ag" = (/obj/item/ammo_casing/a762,/turf/open/floor/plasteel/darkred{baseturf = /turf/open/floor/plating/asteroid/snow},/area/awaymission/snowdin/base)
"ah" = (/obj/structure/chair/office/dark,/turf/open/floor/plasteel/darkred{baseturf = /turf/open/floor/plating/asteroid/snow},/area/awaymission/snowdin/base)
"ai" = (/obj/structure/table/reinforced,/obj/item/weapon/paper_bin,/obj/item/weapon/pen,/obj/item/key,/turf/open/floor/plasteel/darkred{baseturf = /turf/open/floor/plating/asteroid/snow},/area/awaymission/snowdin/base)
"aj" = (/obj/structure/barricade/wooden,/obj/machinery/door/airlock/glass_security{name = "Security Office"; req_access_txt = "63"},/turf/open/floor/plasteel/darkred{baseturf = /turf/open/floor/plating/asteroid/snow},/area/awaymission/snowdin/base)
"ak" = (/obj/structure/table/reinforced,/obj/structure/barricade/wooden,/turf/open/floor/plasteel/darkred{baseturf = /turf/open/floor/plating/asteroid/snow},/area/awaymission/snowdin/base)
"al" = (/obj/structure/cable{icon_state = "0-2"; pixel_y = 1; d2 = 2},/obj/structure/grille,/obj/structure/window/reinforced/fulltile,/turf/open/floor/plating{baseturf = /turf/open/floor/plating/asteroid/snow},/area/awaymission/snowdin/base)
"am" = (/turf/closed/wall{baseturf = /turf/open/floor/plating/asteroid/snow},/area/awaymission/snowdin/base)
"an" = (/obj/structure/grille,/obj/structure/window/reinforced/fulltile/ice,/turf/open/floor/plating{baseturf = /turf/open/floor/plating/asteroid/snow},/area/awaymission/snowdin/base)
"ao" = (/turf/open/floor/plasteel{baseturf = /turf/open/floor/plating/asteroid/snow; wet = 0},/area/awaymission/snowdin/base)
"ap" = (/obj/item/ammo_casing/a762,/turf/open/floor/plasteel{baseturf = /turf/open/floor/plating/asteroid/snow; wet = 0},/area/awaymission/snowdin/base)
"aq" = (/obj/structure/cable{d1 = 1; d2 = 2; icon_state = "1-2"; pixel_y = 0},/turf/open/floor/plasteel{baseturf = /turf/open/floor/plating/asteroid/snow; wet = 0},/area/awaymission/snowdin/base)
"ar" = (/obj/machinery/light{dir = 1},/turf/open/floor/plasteel{baseturf = /turf/open/floor/plating/asteroid/snow; wet = 0},/area/awaymission/snowdin/base)
"as" = (/obj/machinery/recharge_station,/turf/open/floor/plating{baseturf = /turf/open/floor/plating/asteroid/snow},/area/awaymission/snowdin/base)
"at" = (/obj/item/trash/sosjerky,/obj/effect/decal/cleanable/oil,/turf/open/floor/plasteel{baseturf = /turf/open/floor/plating/asteroid/snow; wet = 0},/area/awaymission/snowdin/base)
"au" = (/obj/structure/closet/crate,/obj/item/weapon/survivalcapsule,/obj/item/clothing/gloves/color/black,/obj/item/clothing/gloves/color/black,/obj/item/clothing/suit/hooded/wintercoat,/obj/item/clothing/suit/hooded/wintercoat,/obj/item/clothing/shoes/winterboots,/obj/item/clothing/shoes/winterboots,/obj/effect/turf_decal/bot,/turf/open/floor/plasteel{baseturf = /turf/open/floor/plating/asteroid/snow},/area/awaymission/snowdin/base)
"av" = (/obj/structure/closet/crate,/obj/item/weapon/storage/firstaid/regular,/obj/item/weapon/storage/firstaid/fire,/obj/item/weapon/storage/pill_bottle/stimulant,/obj/effect/turf_decal/bot,/turf/open/floor/plasteel{baseturf = /turf/open/floor/plating/asteroid/snow},/area/awaymission/snowdin/base)
"aw" = (/obj/structure/guncase/shotgun,/obj/item/weapon/gun/ballistic/shotgun/automatic,/obj/item/weapon/gun/ballistic/shotgun/automatic,/obj/item/weapon/gun/ballistic/shotgun/automatic,/turf/open/floor/plating{baseturf = /turf/open/floor/plating/asteroid/snow},/area/awaymission/snowdin/base)
"ax" = (/turf/open/floor/plating{baseturf = /turf/open/floor/plating/asteroid/snow},/area/awaymission/snowdin/base)
"ay" = (/obj/machinery/door/airlock/maintenance_hatch,/turf/open/floor/plating{baseturf = /turf/open/floor/plating/asteroid/snow},/area/awaymission/snowdin/base)
"az" = (/obj/effect/turf_decal/bot,/turf/open/floor/plasteel{baseturf = /turf/open/floor/plating/asteroid/snow},/area/awaymission/snowdin/base)
"aA" = (/obj/structure/closet/crate{icon_state = "crateopen"; opened = 1},/obj/item/weapon/reagent_containers/spray/cleaner,/obj/item/weapon/soap/nanotrasen,/obj/effect/turf_decal/bot,/turf/open/floor/plasteel{baseturf = /turf/open/floor/plating/asteroid/snow},/area/awaymission/snowdin/base)
"aB" = (/obj/machinery/iv_drip,/turf/open/floor/plasteel{baseturf = /turf/open/floor/plating/asteroid/snow; wet = 0},/area/awaymission/snowdin/base)
"aC" = (/obj/effect/spawner/structure/window/reinforced,/turf/open/floor/plating{baseturf = /turf/open/floor/plating/asteroid/snow},/area/awaymission/snowdin/base)
"aD" = (/obj/structure/reagent_dispensers/fueltank,/turf/open/floor/plating{baseturf = /turf/open/floor/plating/asteroid/snow},/area/awaymission/snowdin/base)
"aE" = (/obj/structure/reagent_dispensers/watertank,/turf/open/floor/plating{baseturf = /turf/open/floor/plating/asteroid/snow},/area/awaymission/snowdin/base)
"aF" = (/obj/effect/decal/cleanable/oil,/turf/open/floor/plating{baseturf = /turf/open/floor/plating/asteroid/snow},/area/awaymission/snowdin/base)
"aG" = (/obj/structure/table,/obj/item/weapon/shovel,/turf/open/floor/plating{baseturf = /turf/open/floor/plating/asteroid/snow},/area/awaymission/snowdin/base)
"aH" = (/obj/machinery/light{dir = 8},/turf/open/floor/plasteel{baseturf = /turf/open/floor/plating/asteroid/snow; wet = 0},/area/awaymission/snowdin/base)
"aI" = (/obj/structure/closet/crate,/obj/item/weapon/reagent_containers/food/snacks/grown/wheat,/obj/item/weapon/reagent_containers/food/snacks/grown/wheat,/obj/item/weapon/reagent_containers/food/snacks/grown/wheat,/obj/item/weapon/reagent_containers/food/snacks/grown/wheat,/obj/item/weapon/reagent_containers/food/snacks/grown/tomato,/obj/item/weapon/reagent_containers/food/snacks/grown/tomato,/obj/item/weapon/reagent_containers/food/snacks/grown/tomato,/obj/item/weapon/reagent_containers/food/snacks/grown/corn,/obj/item/weapon/reagent_containers/food/snacks/grown/corn,/obj/item/weapon/reagent_containers/food/snacks/grown/corn,/obj/item/weapon/reagent_containers/food/snacks/grown/cocoapod,/obj/item/weapon/reagent_containers/food/snacks/grown/cocoapod,/obj/effect/turf_decal/bot,/turf/open/floor/plasteel{baseturf = /turf/open/floor/plating/asteroid/snow},/area/awaymission/snowdin/base)
"aJ" = (/obj/machinery/light{dir = 4; icon_state = "tube1"},/obj/machinery/iv_drip,/turf/open/floor/plasteel{baseturf = /turf/open/floor/plating/asteroid/snow; wet = 0},/area/awaymission/snowdin/base)
"aK" = (/obj/structure/table,/obj/item/weapon/storage/toolbox/electrical,/obj/item/weapon/storage/toolbox/electrical,/turf/open/floor/plating{baseturf = /turf/open/floor/plating/asteroid/snow},/area/awaymission/snowdin/base)
"aL" = (/obj/structure/table,/obj/item/weapon/shovel,/obj/item/weapon/paper/crumpled/snowdin/shovel,/turf/open/floor/plating{baseturf = /turf/open/floor/plating/asteroid/snow},/area/awaymission/snowdin/base)
"aM" = (/obj/machinery/power/smes/magical{desc = "A high-capacity superconducting magnetic energy storage (SMES) unit."; name = "power storage unit"},/turf/open/floor/plasteel{baseturf = /turf/open/floor/plating/asteroid/snow; wet = 0},/area/awaymission/snowdin/base)
"aN" = (/obj/machinery/power/terminal{dir = 8},/obj/structure/cable{icon_state = "0-2"; pixel_y = 1; d2 = 2},/turf/open/floor/plasteel{baseturf = /turf/open/floor/plating/asteroid/snow; wet = 0},/area/awaymission/snowdin/base)
"aO" = (/obj/effect/decal/cleanable/oil,/turf/open/floor/plasteel{baseturf = /turf/open/floor/plating/asteroid/snow; wet = 0},/area/awaymission/snowdin/base)
"aP" = (/obj/structure/closet/crate/freezer,/obj/item/weapon/reagent_containers/blood/random,/obj/item/weapon/reagent_containers/blood/random,/obj/item/weapon/reagent_containers/blood/random,/obj/item/weapon/reagent_containers/blood/random,/turf/open/floor/plasteel{baseturf = /turf/open/floor/plating/asteroid/snow; wet = 0},/area/awaymission/snowdin/base)
"aQ" = (/obj/structure/table,/obj/item/weapon/storage/toolbox/mechanical,/obj/item/weapon/storage/toolbox/mechanical,/turf/open/floor/plating{baseturf = /turf/open/floor/plating/asteroid/snow},/area/awaymission/snowdin/base)
"aR" = (/obj/structure/showcase{desc = "A strange machine thats supposedly used to help pick up and decypth wave signals. "; icon = 'icons/obj/machines/telecomms.dmi'; icon_state = "processor"; name = "subsystem signal decrypher"},/turf/open/floor/plating{baseturf = /turf/open/floor/plating/asteroid/snow},/area/awaymission/snowdin/base)
"aS" = (/obj/structure/closet/crate/trashcart,/obj/item/trash/can,/obj/item/trash/semki,/obj/item/toy/figure/captain{name = "Central command action figure"; toysay = "Fire the BSA cannons!"},/obj/item/weapon/storage/box/rubbershot,/obj/item/key,/turf/open/floor/plating{baseturf = /turf/open/floor/plating/asteroid/snow},/area/awaymission/snowdin/base)
"aT" = (/obj/machinery/space_heater,/obj/machinery/light/small,/turf/open/floor/plating{baseturf = /turf/open/floor/plating/asteroid/snow},/area/awaymission/snowdin/base)
"aU" = (/obj/machinery/space_heater,/turf/open/floor/plating{baseturf = /turf/open/floor/plating/asteroid/snow},/area/awaymission/snowdin/base)
"aV" = (/obj/machinery/power/port_gen/pacman,/turf/open/floor/plating{baseturf = /turf/open/floor/plating/asteroid/snow},/area/awaymission/snowdin/base)
"aW" = (/obj/machinery/power/terminal{dir = 8},/obj/structure/cable{icon_state = "0-4"; d2 = 4},/obj/structure/cable{d1 = 1; d2 = 4; icon_state = "1-4"},/turf/open/floor/plasteel{baseturf = /turf/open/floor/plating/asteroid/snow; wet = 0},/area/awaymission/snowdin/base)
"aX" = (/obj/structure/cable{d1 = 1; d2 = 8; icon_state = "1-8"},/turf/open/floor/plasteel{baseturf = /turf/open/floor/plating/asteroid/snow; wet = 0},/area/awaymission/snowdin/base)
"aY" = (/obj/machinery/door/airlock/glass,/turf/open/floor/plasteel/cafeteria{baseturf = /turf/open/floor/plating/asteroid/snow},/area/awaymission/snowdin/base)
"aZ" = (/obj/structure/dresser,/turf/open/floor/carpet{baseturf = /turf/open/floor/plating/asteroid/snow},/area/awaymission/snowdin/base)
"ba" = (/obj/machinery/light/small{dir = 1},/turf/open/floor/carpet{baseturf = /turf/open/floor/plating/asteroid/snow},/area/awaymission/snowdin/base)
"bb" = (/obj/structure/bed,/obj/item/weapon/bedsheet,/turf/open/floor/carpet{baseturf = /turf/open/floor/plating/asteroid/snow},/area/awaymission/snowdin/base)
"bc" = (/obj/structure/bookcase/random/fiction,/turf/open/floor/wood{baseturf = /turf/open/floor/plating/asteroid/snow},/area/awaymission/snowdin/base)
"bd" = (/obj/structure/bookcase/random/nonfiction,/turf/open/floor/wood{baseturf = /turf/open/floor/plating/asteroid/snow},/area/awaymission/snowdin/base)
"be" = (/obj/structure/fireaxecabinet{pixel_y = 32},/turf/open/floor/wood{baseturf = /turf/open/floor/plating/asteroid/snow},/area/awaymission/snowdin/base)
"bf" = (/turf/open/floor/wood{baseturf = /turf/open/floor/plating/asteroid/snow},/area/awaymission/snowdin/base)
"bg" = (/obj/structure/table/wood,/turf/open/floor/carpet{baseturf = /turf/open/floor/plating/asteroid/snow},/area/awaymission/snowdin/base)
"bh" = (/obj/machinery/light{dir = 8},/obj/structure/filingcabinet,/turf/open/floor/plasteel/darkbrown{baseturf = /turf/open/floor/plating/asteroid/snow},/area/awaymission/snowdin/base)
"bi" = (/obj/structure/table,/obj/item/weapon/paper_bin,/obj/item/weapon/pen,/turf/open/floor/plasteel/darkbrown{baseturf = /turf/open/floor/plating/asteroid/snow},/area/awaymission/snowdin/base)
"bj" = (/obj/structure/table,/turf/open/floor/plasteel/darkbrown{baseturf = /turf/open/floor/plating/asteroid/snow},/area/awaymission/snowdin/base)
"bk" = (/obj/structure/table,/obj/item/device/flashlight/lamp,/turf/open/floor/plasteel/darkbrown{baseturf = /turf/open/floor/plating/asteroid/snow},/area/awaymission/snowdin/base)
"bl" = (/turf/open/floor/plasteel/cafeteria{baseturf = /turf/open/floor/plating/asteroid/snow},/area/awaymission/snowdin/base)
"bm" = (/obj/machinery/light{dir = 1},/obj/machinery/vending/coffee,/turf/open/floor/plasteel/cafeteria{baseturf = /turf/open/floor/plating/asteroid/snow},/area/awaymission/snowdin/base)
"bn" = (/obj/structure/table,/obj/machinery/microwave,/turf/open/floor/plasteel/cafeteria{baseturf = /turf/open/floor/plating/asteroid/snow},/area/awaymission/snowdin/base)
"bo" = (/obj/structure/closet/cabinet,/obj/item/clothing/shoes/winterboots,/obj/item/clothing/suit/hooded/wintercoat,/obj/item/clothing/gloves/color/black,/turf/open/floor/carpet{baseturf = /turf/open/floor/plating/asteroid/snow},/area/awaymission/snowdin/base)
"bp" = (/turf/open/floor/carpet{baseturf = /turf/open/floor/plating/asteroid/snow},/area/awaymission/snowdin/base)
"bq" = (/obj/machinery/door/airlock{name = "Dorm Room"},/turf/open/floor/carpet{baseturf = /turf/open/floor/plating/asteroid/snow},/area/awaymission/snowdin/base)
"br" = (/obj/machinery/light/small{dir = 4},/turf/open/floor/carpet{baseturf = /turf/open/floor/plating/asteroid/snow},/area/awaymission/snowdin/base)
"bs" = (/turf/open/floor/plasteel/darkbrown{baseturf = /turf/open/floor/plating/asteroid/snow},/area/awaymission/snowdin/base)
"bt" = (/obj/structure/chair{dir = 1},/turf/open/floor/plasteel/darkbrown{baseturf = /turf/open/floor/plating/asteroid/snow},/area/awaymission/snowdin/base)
"bu" = (/obj/item/weapon/cigbutt,/turf/open/floor/plasteel/cafeteria{baseturf = /turf/open/floor/plating/asteroid/snow},/area/awaymission/snowdin/base)
"bv" = (/obj/structure/chair/comfy/beige,/turf/open/floor/plasteel/cafeteria{baseturf = /turf/open/floor/plating/asteroid/snow},/area/awaymission/snowdin/base)
"bw" = (/obj/structure/chair/stool,/turf/open/floor/wood{baseturf = /turf/open/floor/plating/asteroid/snow},/area/awaymission/snowdin/base)
"bx" = (/obj/machinery/hydroponics/constructable,/turf/open/floor/plasteel/cafeteria{baseturf = /turf/open/floor/plating/asteroid/snow},/area/awaymission/snowdin/base)
"by" = (/obj/structure/table/wood,/obj/item/trash/cheesie,/turf/open/floor/plasteel/cafeteria{baseturf = /turf/open/floor/plating/asteroid/snow},/area/awaymission/snowdin/base)
"bz" = (/obj/effect/decal/cleanable/blood/drip,/turf/open/floor/wood{baseturf = /turf/open/floor/plating/asteroid/snow},/area/awaymission/snowdin/base)
"bA" = (/obj/machinery/light{dir = 1},/turf/open/floor/wood{baseturf = /turf/open/floor/plating/asteroid/snow},/area/awaymission/snowdin/base)
"bB" = (/obj/structure/table/wood,/obj/item/toy/cards/deck,/turf/open/floor/wood{baseturf = /turf/open/floor/plating/asteroid/snow},/area/awaymission/snowdin/base)
"bC" = (/obj/structure/table/wood,/obj/item/trash/candle,/turf/open/floor/wood{baseturf = /turf/open/floor/plating/asteroid/snow},/area/awaymission/snowdin/base)
"bD" = (/obj/machinery/door/airlock/hatch,/turf/open/floor/plasteel/darkbrown{baseturf = /turf/open/floor/plating/asteroid/snow},/area/awaymission/snowdin/base)
"bE" = (/obj/structure/table/wood,/obj/item/pizzabox/mushroom,/turf/open/floor/plasteel/cafeteria{baseturf = /turf/open/floor/plating/asteroid/snow},/area/awaymission/snowdin/base)
"bF" = (/obj/structure/table/wood,/obj/item/weapon/storage/pill_bottle/dice,/turf/open/floor/wood{baseturf = /turf/open/floor/plating/asteroid/snow},/area/awaymission/snowdin/base)
"bG" = (/obj/structure/table/wood,/obj/item/weapon/paper/crumpled/snowdin/snowdingatewaynotice,/turf/open/floor/wood{baseturf = /turf/open/floor/plating/asteroid/snow},/area/awaymission/snowdin/base)
"bH" = (/obj/structure/table/wood,/obj/item/key,/turf/open/floor/carpet{baseturf = /turf/open/floor/plating/asteroid/snow},/area/awaymission/snowdin/base)
"bI" = (/obj/structure/bed,/obj/item/weapon/bedsheet,/obj/effect/decal/cleanable/blood/gibs,/obj/effect/gibspawner/human,/turf/open/floor/carpet{baseturf = /turf/open/floor/plating/asteroid/snow},/area/awaymission/snowdin/base)
"bJ" = (/obj/structure/table/wood,/obj/item/trash/can,/turf/open/floor/plasteel/cafeteria{baseturf = /turf/open/floor/plating/asteroid/snow},/area/awaymission/snowdin/base)
"bK" = (/obj/effect/decal/cleanable/blood,/turf/open/floor/wood{baseturf = /turf/open/floor/plating/asteroid/snow},/area/awaymission/snowdin/base)
"bL" = (/obj/machinery/door/airlock{name = "Dorm Room"},/obj/structure/barricade/wooden,/turf/open/floor/carpet{baseturf = /turf/open/floor/plating/asteroid/snow},/area/awaymission/snowdin/base)
"bM" = (/obj/effect/decal/cleanable/blood/gibs,/obj/effect/decal/remains/human,/turf/open/floor/carpet{baseturf = /turf/open/floor/plating/asteroid/snow},/area/awaymission/snowdin/base)
"bN" = (/obj/machinery/light/small{dir = 4},/mob/living/simple_animal/hostile/bear/snow,/turf/open/floor/carpet{baseturf = /turf/open/floor/plating/asteroid/snow},/area/awaymission/snowdin/base)
"bO" = (/obj/structure/chair,/turf/open/floor/plasteel/darkbrown{baseturf = /turf/open/floor/plating/asteroid/snow},/area/awaymission/snowdin/base)
"bP" = (/obj/structure/chair/comfy/beige{dir = 1; icon_state = "comfychair"},/turf/open/floor/plasteel/cafeteria{baseturf = /turf/open/floor/plating/asteroid/snow},/area/awaymission/snowdin/base)
"bQ" = (/obj/machinery/light,/turf/open/floor/wood{baseturf = /turf/open/floor/plating/asteroid/snow},/area/awaymission/snowdin/base)
"bR" = (/obj/machinery/light{dir = 8},/obj/structure/filingcabinet,/obj/item/weapon/paper/snowdin/snowdinlog,/turf/open/floor/plasteel/darkbrown{baseturf = /turf/open/floor/plating/asteroid/snow},/area/awaymission/snowdin/base)
"bS" = (/obj/machinery/light,/obj/machinery/vending/cigarette,/turf/open/floor/plasteel/cafeteria{baseturf = /turf/open/floor/plating/asteroid/snow},/area/awaymission/snowdin/base)
"bT" = (/obj/structure/table,/turf/open/floor/plasteel/cafeteria{baseturf = /turf/open/floor/plating/asteroid/snow},/area/awaymission/snowdin/base)
"bU" = (/obj/machinery/door/airlock{name = "Dorms"},/turf/open/floor/wood{baseturf = /turf/open/floor/plating/asteroid/snow},/area/awaymission/snowdin/base)
"bV" = (/obj/effect/decal/cleanable/blood/drip,/turf/open/floor/plasteel{baseturf = /turf/open/floor/plating/asteroid/snow; wet = 0},/area/awaymission/snowdin/base)
"bW" = (/obj/machinery/door/airlock/external,/turf/open/floor/plating{baseturf = /turf/open/floor/plating/asteroid/snow},/area/awaymission/snowdin/base)
"bX" = (/obj/structure/flora/bush,/turf/open/floor/plating/asteroid/snow,/area/awaymission/snowdin)
"bY" = (/obj/machinery/light/small{dir = 1},/turf/open/floor/plating/asteroid/snow,/area/awaymission/snowdin/base)
"bZ" = (/turf/open/floor/plating/snowed,/area/awaymission/snowdin)

(1,1,1) = {"
aaaaaaaaaaaaaaaaaaaaaaaaaaaaaaaaaaaaaaaaaaaaaaaaaaaaaaaaaaaa
aaaaaaaaaaaaaaaaaaaaaaaaabababababababababababababaaaaaaaaaa
aaaaaaaaaaaaaaaaaaaaababababacacacacacababababababababaaaaaa
aaaaaaaaaaaaaaaaaaabababababacadaeafacabababababababababaaaa
aaaaaaaaaaaaaaabababababababacagahaiacababababababababababaa
aaaaaaaaaaaaababababababababacajakalamacacacacacacanabababaa
aaaaaaaaaaabababababababacacamaoapaqaoaoaoaraoaoaoaoanababaa
aaaaaaaaababababababanacasasamaoataqaoaoaoaoauaoavaoaoanabab
aaaaaaabababababananawaxaxaxayaoaoaqaoaoaoarazaoaAaoaBacabab
aaaaaaabababacaCaDaEaxaxaFaGamaHaoaqaoaoaoaoaIaoazaoaJacabab
aaaaaaababacaKaFaxaxaxaFaxaLamaMaNaqaoaoaoaoaoaoaOaoaPacabab
aaaaabababacaQaxaRaSaTaUaVaGamaMaWaXaoaoaoaoaoaoaoaoaoacabab
aaaaabababacamamamamamamamamamamamamamamamamamaYamamamacabab
aaaaabababacaZbabbambcbdbebfambgbbambhbibjbkamblbmbnbnacabab
aaaaabababacbobpbgambfbfbfbfbqbpbrambsbsbtbsamblblbubvanabab
aaaaabababacambqamambfbwbfbfamboaZambsbsbsbsambxblblbyanabab
aaaaabababanbfbzbAbwbBbCbfbfamamamambsbsbsbsbDbublblbEanabab
aaaaabababanbfbfbfbfbFbGbwbfambHbIambsbsbsbsambxblblbJanabab
aaaaabababanbfbfbfbfbwbfbzbKbLbMbNambsbsbObsamblblblbPanabab
aaaaabababanbfbfbfbfbzbfbQbfamboaZambRbkbjbiamblbSbTbTacabab
aaaaabababacamamambUamamamamamamamamamamamamamaYamamamacabab
aaaaaaababacaoaraoaoaoaoaoaoaoaoaoaraoaoaoaoaoaoaoaraoacabab
aaaaaaababacaoaoaobVbVaobVaoaoaoaoaoaoaoaoaoaoaoaoaoaoacabab
aaaaaaababacacananananananacacambWambWamacacacacacacacacabaa
aaaaaaaaabababababababababababanaxaCaxanabababababababababaa
aaaaaaaaabababababababababababanaxaCaxanabababababababababaa
aaaaaaaaaaababababababababababacbWacbWacababababababababaaaa
aaaaaaaaaaabababababababbXababbYbZbZbZbYababababababababaaaa
aaaaaaaaaaaaababababababababababababababababababababababaaaa
aaaaaaaaaaaaaaaaaaabababababababababababababababaaaaaaaaaaaa
"}
