"a" = (/obj/structure/flora/tree/pine,/turf/open/floor/grass/snow,/area/space)
"b" = (/turf/open/floor/grass/snow,/area/space)

(1,1,1) = {"
aababbbbbb
bbbabbbbbb
bbbbbbabbb
babbbabbbb
bbbbbbaaba
bbabbbbbbb
bbbbbabbbb
babbbbbbab
abbbbbabbb
bbbbabbbab
"}
